1111111111111
10C1000C000C1
1C00011111001
1P0011E000011
1111111111111