1111111111
1PCE111001
110CCCCC11
1111111111